XXXXXXXXX
X       X  
X       X  
X       XXXX
X          X
X          X
X          X
X          X
X     XXX  X
X  R  X    X
X     X    X
XXXOXXXXXOXX