XXXXXXXXX
X       X  
X   E   X  
X       XXXX
X          X
X          X
X          X
X          X
X     XXX  X
X  S  X    X
X     X    X
XXXOXXXXXOXX