XXXXXXXXX
X       X  
X       X  
X  E    XXXX
X          X
X          X
X          X
X          X
X     XXX  X
X  S  X    X
X     X    X
XXXOXXXXXOXX